 xxxxxxxxxxxxxxxxxxxxxxxxxxxxxxxxxxxxxxxxxx 
      x       xxxxx       x     x        xx 
 xxxx xxxxx x  xxx  xxxxx  xx x x xxxxxx  x 
 x  x     x  x  x  xx    x x  x   x    xx x 
 xx  x xx   x x x x   xx x  x  xxx x x    x 
 x x xx  x xx   x x xx x x x x x   x  xx xx 
 x      xxx   xx   x     x x   x x  x   x x 
 x xx x  x  xx xx x  xx x  x x x  x  xx   x 
 xx x x x  x x     x  x x xxx  x xxx x xx x 
 x    x x x   xxx x x  x  xxx x   xx   x  x 
 x xxx x  x x     x   x  x x  x x   x x  xx 
 x     x x   x x x  x   x    xx  xx xx  x x 
 x xxx x  xx x  x  x xxx  xxx   x x    x  x 
 x   x  x x  xx  x x     x  x xx   x xx x x 
 xx x x x  x  xx x   xxxx  xx x  x  x   x x 
 xx   x x x x  x  xxx    x    x x x x x   x 
 x  x x x x  x x x  x x xx xxxx   x   xx xx 
 x x xx   x xx x  x x x x  x   xx  xxx   xx 
 x x   xxx     xx x x x   x x x  x x x x  x 
 x x x   x xxxx x x x  xxxx     xx   x  x x 
 x  x  xx  x    x x   x    x xxx  x x  xx x 
 xx  x xx x x x x  x x  xx x     x  x xx  x 
 x x x    x x x  x x  x x   x xx   x  x  xx 
 x x x xxx    x x  xx   x x  x   xx  xxx  x 
 x x x     xx  x  x  xxxxx x x xx   x x x x 
 x x  xxx x   x  x  x   x  x x xx xx    x x 
 x x x   xx xx  x x   x   x   x   x  x xx x 
 x   x xx   x  x   x x x x  xx  x x x  x  x 
 x xx  x  xx x  xx x   x x x   x x  xx   xx 
 x  xx   x    x  x xxx x x x xx  x x  xxxxx 
 xx   x x  xx xx x   x x x   xx x  x x   xx 
 x xx x   x    x  xx x x  xxx   x x    x  x 
 x  x xx x x x  x x  x  x   x x x  x xx  xx 
 x xx  xx   xxx x  x  x  xx    x  x  x x  x 
 x   x    x  xx  x x xxx  xxx x  xxx x  x x 
 x x  xxxx x   xx  x xxx x     x xx  x x  x 
 xx  x      xx x  x   x  x x xxx    x  x xx 
 x  x  xxx xx  x x  x   xx  x   xxxxxx x  x 
 xx  x   x    x   x  xxx  x   x     x   x x 
 x x x xx xxxx xx  x x   x xxx x xxx  x x x 
 x                x    x       x     x      
 xxxxxxxxxxxxxxxxxxxxxxxxxxxxxxxxxxxxxxxxxx 
                                            

